A## ###                         ##############         ####|
 ##     ###################### #####           ####### ####|
 ## ######                  ## ##### ################# ####|
    ################### ### ## ##### ################# ####|
 ###################### ### ## ##### ################# ####|
 ###                    ### ##       ################# ####|
 ### ###################### #################          ####|
 ### # ####################                   #############|
 ### # ##       ###########################################|
 ### # ## ##### ###########################################|
 ### # ## ##### ###########################################|
     # ## ##### ###########################################|
### ## ## #####                           #################|
##     ## ############################### #################|
## ######         ####################### #################|
## ############## ####################### #################|
## ############## ####################### #################|
## ############## ####################### #################|
## ############## ####################### #################|
## ############## ####################### #################|
## ############## ####################### #################|
## ############## ####################### #################|
##                ####################### #################|
#########################################                 B|