A##*###*************************##############*********####
*##*****######################*#####***********#######*####
*##*######******************##*#####*#################*####
****###################*###*##*#####*#################*####
*######################*###*##*#####*#################*####
*###********************###*##*******#################*####
*###*######################*#################**********####
*###*# ####################*******************#############
*###*# ##*******###########################################
*###*# ##*#####*###########################################
*###*# ##*#####*###########################################
*****# ##*#####*###########################################
###*## ##*#####***************************#################
##**   ##*###############################*#################
##*######*********#######################*#################
##*##############*#######################*#################
##*##############*#######################*#################
##*##############*#######################*#################
##*##############*#######################*#################
##*##############*#######################*#################
##*##############*#######################*#################
##*##############*#######################*#################
##****************#######################*#################
#########################################*****************B
